0000000000000001
1000000000000001
1000000000000001
1000000000000001
1000000000000001
1000000000000001
1000000011000001
1000000000000001
1000000000000001
1000111111000001
1000000000000001
1000000000000001
1000000000000001
1111111111111111
