000000000000000
000000000000000
000000000000000
000000000000000
000000000000000
000000000000000
000000001100000
000000011100000
000001111100000
111111111111111

